##########   
#        ####
#  .  @  #  #
#  .$$$  #  #
#  .     ####
##########   