##########
#  ..    #
#  .  @  #
#  .$ $  #
##########