##########
#        #
#  .  @  #
#  .$ $  #
##########