##########
#  ..  $ #
#  .$ $ @#
#  .$    #
##########