##########   
#........####
# $$$$$$$#  #
#.$......#  #
#.$$$$$$ #  #
#......$@#  #
#$$$$$$$ #  #
#        ####
##########   