#### ####
#  ###  #
# $ . $ #
#   @   #
### .$###
  # . #
  #####