         #####    
##########   #    
#. ........ .##   
#  ####    #  ##  
## $   #    #  ## 
 # $  # #    #  ##
 # $ $ # #    #  #
 # $  $   #    @ #
 # $ $$  #       #
 # $## ###########
 #  #  #          
 #    ##          
 ######           